#level_1
0000000000
1111111111
2222222222
ZZZZZZZZZZ
3333333333
##level_1

#level_2
1231ZZ3123
1231ZZ3123
1231ZZ3123
1231ZZ3123
1122334455
##level_2
