#level_1
0000000000
1111111111
2222222222
7777777777
3333333333
##level_1

#level_2
1231773123
1231773123
1231773123
1231773123
1122334455
##level_2
